param level:=42; 
param p:= 65521; 
param uba:= 32760; 
param halfn:= 55; 
param: i:
       Mset:=
      1 0
      2 1
      3 2
      4 3
      5 4
      6 5
      7 6
      8 7
      9 8
      10 9
      11 10
      12 11
      13 12
      14 13
      15 14
      16 15
      17 16
      18 17
      19 18
      20 19
      21 20
      22 21
      23 22
      24 23
      25 24
      26 25
      27 26
      28 27
      29 27
      30 26
      31 25
      32 24
      33 23
      34 22
      35 21
      36 20
      37 19
      38 18
      39 17
      40 16
      41 15
      42 14
      43 13
      44 12
      45 11
      46 10
      47 9
      48 8
      49 7
      50 6
      51 5
      52 4
      53 3
      54 2
      55 1; 
param T:  1 2 3 4 5 6 7 8 9 10 11 12 13 14 15 16 17 18 19 20 21 22 23 24 25 26 27 28 29 30 31 32 33 34 35 36 37 38 39 40 41 42 43 44 45 46 47 48 49 50 51 52 53 54 55:=
        1 245 205 182  54  20 210  76 189 200  70 101 172 132 171 115  40 142 196
 118 154  26 102  12  81  81 135  71 208  22  26  21 229 139  26  53 198
 226 191 193  59   3  70 202 216 245 170 211 153 175 154 160 245 158 114
  50
        2  50 245 205 182  54  20 210  76 189 200  70 101 172 132 171 115  40 142
 196 118 154  26 102  12  81  81 135  71 208  22  26  21 229 139  26  53
 198 226 191 193  59   3  70 202 216 245 170 211 153 175 154 160 245 158
 114
        3 114  50 245 205 182  54  20 210  76 189 200  70 101 172 132 171 115  40
 142 196 118 154  26 102  12  81  81 135  71 208  22  26  21 229 139  26
  53 198 226 191 193  59   3  70 202 216 245 170 211 153 175 154 160 245
 158
        4 158 114  50 245 205 182  54  20 210  76 189 200  70 101 172 132 171 115
  40 142 196 118 154  26 102  12  81  81 135  71 208  22  26  21 229 139
  26  53 198 226 191 193  59   3  70 202 216 245 170 211 153 175 154 160
 245
        5 245 158 114  50 245 205 182  54  20 210  76 189 200  70 101 172 132 171
 115  40 142 196 118 154  26 102  12  81  81 135  71 208  22  26  21 229
 139  26  53 198 226 191 193  59   3  70 202 216 245 170 211 153 175 154
 160
        6 160 245 158 114  50 245 205 182  54  20 210  76 189 200  70 101 172 132
 171 115  40 142 196 118 154  26 102  12  81  81 135  71 208  22  26  21
 229 139  26  53 198 226 191 193  59   3  70 202 216 245 170 211 153 175
 154
        7 154 160 245 158 114  50 245 205 182  54  20 210  76 189 200  70 101 172
 132 171 115  40 142 196 118 154  26 102  12  81  81 135  71 208  22  26
  21 229 139  26  53 198 226 191 193  59   3  70 202 216 245 170 211 153
 175
        8 175 154 160 245 158 114  50 245 205 182  54  20 210  76 189 200  70 101
 172 132 171 115  40 142 196 118 154  26 102  12  81  81 135  71 208  22
  26  21 229 139  26  53 198 226 191 193  59   3  70 202 216 245 170 211
 153
        9 153 175 154 160 245 158 114  50 245 205 182  54  20 210  76 189 200  70
 101 172 132 171 115  40 142 196 118 154  26 102  12  81  81 135  71 208
  22  26  21 229 139  26  53 198 226 191 193  59   3  70 202 216 245 170
 211
        10 211 153 175 154 160 245 158 114  50 245 205 182  54  20 210  76 189 200
  70 101 172 132 171 115  40 142 196 118 154  26 102  12  81  81 135  71
 208  22  26  21 229 139  26  53 198 226 191 193  59   3  70 202 216 245
 170
        11 170 211 153 175 154 160 245 158 114  50 245 205 182  54  20 210  76 189
 200  70 101 172 132 171 115  40 142 196 118 154  26 102  12  81  81 135
  71 208  22  26  21 229 139  26  53 198 226 191 193  59   3  70 202 216
 245
        12 245 170 211 153 175 154 160 245 158 114  50 245 205 182  54  20 210  76
 189 200  70 101 172 132 171 115  40 142 196 118 154  26 102  12  81  81
 135  71 208  22  26  21 229 139  26  53 198 226 191 193  59   3  70 202
 216
        13 216 245 170 211 153 175 154 160 245 158 114  50 245 205 182  54  20 210
  76 189 200  70 101 172 132 171 115  40 142 196 118 154  26 102  12  81
  81 135  71 208  22  26  21 229 139  26  53 198 226 191 193  59   3  70
 202
        14 202 216 245 170 211 153 175 154 160 245 158 114  50 245 205 182  54  20
 210  76 189 200  70 101 172 132 171 115  40 142 196 118 154  26 102  12
  81  81 135  71 208  22  26  21 229 139  26  53 198 226 191 193  59   3
  70
        15  70 202 216 245 170 211 153 175 154 160 245 158 114  50 245 205 182  54
  20 210  76 189 200  70 101 172 132 171 115  40 142 196 118 154  26 102
  12  81  81 135  71 208  22  26  21 229 139  26  53 198 226 191 193  59
   3
        16   3  70 202 216 245 170 211 153 175 154 160 245 158 114  50 245 205 182
  54  20 210  76 189 200  70 101 172 132 171 115  40 142 196 118 154  26
 102  12  81  81 135  71 208  22  26  21 229 139  26  53 198 226 191 193
  59
        17  59   3  70 202 216 245 170 211 153 175 154 160 245 158 114  50 245 205
 182  54  20 210  76 189 200  70 101 172 132 171 115  40 142 196 118 154
  26 102  12  81  81 135  71 208  22  26  21 229 139  26  53 198 226 191
 193
        18 193  59   3  70 202 216 245 170 211 153 175 154 160 245 158 114  50 245
 205 182  54  20 210  76 189 200  70 101 172 132 171 115  40 142 196 118
 154  26 102  12  81  81 135  71 208  22  26  21 229 139  26  53 198 226
 191
        19 191 193  59   3  70 202 216 245 170 211 153 175 154 160 245 158 114  50
 245 205 182  54  20 210  76 189 200  70 101 172 132 171 115  40 142 196
 118 154  26 102  12  81  81 135  71 208  22  26  21 229 139  26  53 198
 226
        20 226 191 193  59   3  70 202 216 245 170 211 153 175 154 160 245 158 114
  50 245 205 182  54  20 210  76 189 200  70 101 172 132 171 115  40 142
 196 118 154  26 102  12  81  81 135  71 208  22  26  21 229 139  26  53
 198
        21 198 226 191 193  59   3  70 202 216 245 170 211 153 175 154 160 245 158
 114  50 245 205 182  54  20 210  76 189 200  70 101 172 132 171 115  40
 142 196 118 154  26 102  12  81  81 135  71 208  22  26  21 229 139  26
  53
        22  53 198 226 191 193  59   3  70 202 216 245 170 211 153 175 154 160 245
 158 114  50 245 205 182  54  20 210  76 189 200  70 101 172 132 171 115
  40 142 196 118 154  26 102  12  81  81 135  71 208  22  26  21 229 139
  26
        23  26  53 198 226 191 193  59   3  70 202 216 245 170 211 153 175 154 160
 245 158 114  50 245 205 182  54  20 210  76 189 200  70 101 172 132 171
 115  40 142 196 118 154  26 102  12  81  81 135  71 208  22  26  21 229
 139
        24 139  26  53 198 226 191 193  59   3  70 202 216 245 170 211 153 175 154
 160 245 158 114  50 245 205 182  54  20 210  76 189 200  70 101 172 132
 171 115  40 142 196 118 154  26 102  12  81  81 135  71 208  22  26  21
 229
        25 229 139  26  53 198 226 191 193  59   3  70 202 216 245 170 211 153 175
 154 160 245 158 114  50 245 205 182  54  20 210  76 189 200  70 101 172
 132 171 115  40 142 196 118 154  26 102  12  81  81 135  71 208  22  26
  21
        26  21 229 139  26  53 198 226 191 193  59   3  70 202 216 245 170 211 153
 175 154 160 245 158 114  50 245 205 182  54  20 210  76 189 200  70 101
 172 132 171 115  40 142 196 118 154  26 102  12  81  81 135  71 208  22
  26
        27  26  21 229 139  26  53 198 226 191 193  59   3  70 202 216 245 170 211
 153 175 154 160 245 158 114  50 245 205 182  54  20 210  76 189 200  70
 101 172 132 171 115  40 142 196 118 154  26 102  12  81  81 135  71 208
  22
        28  22  26  21 229 139  26  53 198 226 191 193  59   3  70 202 216 245 170
 211 153 175 154 160 245 158 114  50 245 205 182  54  20 210  76 189 200
  70 101 172 132 171 115  40 142 196 118 154  26 102  12  81  81 135  71
 208
        29 208  22  26  21 229 139  26  53 198 226 191 193  59   3  70 202 216 245
 170 211 153 175 154 160 245 158 114  50 245 205 182  54  20 210  76 189
 200  70 101 172 132 171 115  40 142 196 118 154  26 102  12  81  81 135
  71
        30  71 208  22  26  21 229 139  26  53 198 226 191 193  59   3  70 202 216
 245 170 211 153 175 154 160 245 158 114  50 245 205 182  54  20 210  76
 189 200  70 101 172 132 171 115  40 142 196 118 154  26 102  12  81  81
 135
        31 135  71 208  22  26  21 229 139  26  53 198 226 191 193  59   3  70 202
 216 245 170 211 153 175 154 160 245 158 114  50 245 205 182  54  20 210
  76 189 200  70 101 172 132 171 115  40 142 196 118 154  26 102  12  81
  81
        32  81 135  71 208  22  26  21 229 139  26  53 198 226 191 193  59   3  70
 202 216 245 170 211 153 175 154 160 245 158 114  50 245 205 182  54  20
 210  76 189 200  70 101 172 132 171 115  40 142 196 118 154  26 102  12
  81
        33  81  81 135  71 208  22  26  21 229 139  26  53 198 226 191 193  59   3
  70 202 216 245 170 211 153 175 154 160 245 158 114  50 245 205 182  54
  20 210  76 189 200  70 101 172 132 171 115  40 142 196 118 154  26 102
  12
        34  12  81  81 135  71 208  22  26  21 229 139  26  53 198 226 191 193  59
   3  70 202 216 245 170 211 153 175 154 160 245 158 114  50 245 205 182
  54  20 210  76 189 200  70 101 172 132 171 115  40 142 196 118 154  26
 102
        35 102  12  81  81 135  71 208  22  26  21 229 139  26  53 198 226 191 193
  59   3  70 202 216 245 170 211 153 175 154 160 245 158 114  50 245 205
 182  54  20 210  76 189 200  70 101 172 132 171 115  40 142 196 118 154
  26
        36  26 102  12  81  81 135  71 208  22  26  21 229 139  26  53 198 226 191
 193  59   3  70 202 216 245 170 211 153 175 154 160 245 158 114  50 245
 205 182  54  20 210  76 189 200  70 101 172 132 171 115  40 142 196 118
 154
        37 154  26 102  12  81  81 135  71 208  22  26  21 229 139  26  53 198 226
 191 193  59   3  70 202 216 245 170 211 153 175 154 160 245 158 114  50
 245 205 182  54  20 210  76 189 200  70 101 172 132 171 115  40 142 196
 118
        38 118 154  26 102  12  81  81 135  71 208  22  26  21 229 139  26  53 198
 226 191 193  59   3  70 202 216 245 170 211 153 175 154 160 245 158 114
  50 245 205 182  54  20 210  76 189 200  70 101 172 132 171 115  40 142
 196
        39 196 118 154  26 102  12  81  81 135  71 208  22  26  21 229 139  26  53
 198 226 191 193  59   3  70 202 216 245 170 211 153 175 154 160 245 158
 114  50 245 205 182  54  20 210  76 189 200  70 101 172 132 171 115  40
 142
        40 142 196 118 154  26 102  12  81  81 135  71 208  22  26  21 229 139  26
  53 198 226 191 193  59   3  70 202 216 245 170 211 153 175 154 160 245
 158 114  50 245 205 182  54  20 210  76 189 200  70 101 172 132 171 115
  40
        41  40 142 196 118 154  26 102  12  81  81 135  71 208  22  26  21 229 139
  26  53 198 226 191 193  59   3  70 202 216 245 170 211 153 175 154 160
 245 158 114  50 245 205 182  54  20 210  76 189 200  70 101 172 132 171
 115
        42 115  40 142 196 118 154  26 102  12  81  81 135  71 208  22  26  21 229
 139  26  53 198 226 191 193  59   3  70 202 216 245 170 211 153 175 154
 160 245 158 114  50 245 205 182  54  20 210  76 189 200  70 101 172 132
 171
        43 171 115  40 142 196 118 154  26 102  12  81  81 135  71 208  22  26  21
 229 139  26  53 198 226 191 193  59   3  70 202 216 245 170 211 153 175
 154 160 245 158 114  50 245 205 182  54  20 210  76 189 200  70 101 172
 132
        44 132 171 115  40 142 196 118 154  26 102  12  81  81 135  71 208  22  26
  21 229 139  26  53 198 226 191 193  59   3  70 202 216 245 170 211 153
 175 154 160 245 158 114  50 245 205 182  54  20 210  76 189 200  70 101
 172
        45 172 132 171 115  40 142 196 118 154  26 102  12  81  81 135  71 208  22
  26  21 229 139  26  53 198 226 191 193  59   3  70 202 216 245 170 211
 153 175 154 160 245 158 114  50 245 205 182  54  20 210  76 189 200  70
 101
        46 101 172 132 171 115  40 142 196 118 154  26 102  12  81  81 135  71 208
  22  26  21 229 139  26  53 198 226 191 193  59   3  70 202 216 245 170
 211 153 175 154 160 245 158 114  50 245 205 182  54  20 210  76 189 200
  70
        47  70 101 172 132 171 115  40 142 196 118 154  26 102  12  81  81 135  71
 208  22  26  21 229 139  26  53 198 226 191 193  59   3  70 202 216 245
 170 211 153 175 154 160 245 158 114  50 245 205 182  54  20 210  76 189
 200
        48 200  70 101 172 132 171 115  40 142 196 118 154  26 102  12  81  81 135
  71 208  22  26  21 229 139  26  53 198 226 191 193  59   3  70 202 216
 245 170 211 153 175 154 160 245 158 114  50 245 205 182  54  20 210  76
 189
        49 189 200  70 101 172 132 171 115  40 142 196 118 154  26 102  12  81  81
 135  71 208  22  26  21 229 139  26  53 198 226 191 193  59   3  70 202
 216 245 170 211 153 175 154 160 245 158 114  50 245 205 182  54  20 210
  76
        50  76 189 200  70 101 172 132 171 115  40 142 196 118 154  26 102  12  81
  81 135  71 208  22  26  21 229 139  26  53 198 226 191 193  59   3  70
 202 216 245 170 211 153 175 154 160 245 158 114  50 245 205 182  54  20
 210
        51 210  76 189 200  70 101 172 132 171 115  40 142 196 118 154  26 102  12
  81  81 135  71 208  22  26  21 229 139  26  53 198 226 191 193  59   3
  70 202 216 245 170 211 153 175 154 160 245 158 114  50 245 205 182  54
  20
        52  20 210  76 189 200  70 101 172 132 171 115  40 142 196 118 154  26 102
  12  81  81 135  71 208  22  26  21 229 139  26  53 198 226 191 193  59
   3  70 202 216 245 170 211 153 175 154 160 245 158 114  50 245 205 182
  54
        53  54  20 210  76 189 200  70 101 172 132 171 115  40 142 196 118 154  26
 102  12  81  81 135  71 208  22  26  21 229 139  26  53 198 226 191 193
  59   3  70 202 216 245 170 211 153 175 154 160 245 158 114  50 245 205
 182
        54 182  54  20 210  76 189 200  70 101 172 132 171 115  40 142 196 118 154
  26 102  12  81  81 135  71 208  22  26  21 229 139  26  53 198 226 191
 193  59   3  70 202 216 245 170 211 153 175 154 160 245 158 114  50 245
 205
        55 205 182  54  20 210  76 189 200  70 101 172 132 171 115  40 142 196 118
 154  26 102  12  81  81 135  71 208  22  26  21 229 139  26  53 198 226
 191 193  59   3  70 202 216 245 170 211 153 175 154 160 245 158 114  50
 245;