param level:=42; 
param p:= 65521; 
param uba:= 32760; 
param halfn:= 55; 
param: i:
       Mset:=
      1 0
      2 1
      3 2
      4 3
      5 4
      6 5
      7 6
      8 7
      9 8
      10 9
      11 10
      12 11
      13 12
      14 13
      15 14
      16 15
      17 16
      18 17
      19 18
      20 19
      21 20
      22 21
      23 22
      24 23
      25 24
      26 25
      27 26
      28 27
      29 27
      30 26
      31 25
      32 24
      33 23
      34 22
      35 21
      36 20
      37 19
      38 18
      39 17
      40 16
      41 15
      42 14
      43 13
      44 12
      45 11
      46 10
      47 9
      48 8
      49 7
      50 6
      51 5
      52 4
      53 3
      54 2
      55 1; 
param T:  1 2 3 4 5 6 7 8 9 10 11 12 13 14 15 16 17 18 19 20 21 22 23 24 25 26 27 28 29 30 31 32 33 34 35 36 37 38 39 40 41 42 43 44 45 46 47 48 49 50 51 52 53 54 55:=
        1 105 245  70 226 229 107 203 236 164  68  63  91 171 165 120 249 208  18
 213 163 155  16 190   5 236 217  69 231 156 170 138  91 161 110 140  58
 218 228 178  59 205  43 177  39  30 237  89 192 164  95  94 154  31  74
 195
        2 195 105 245  70 226 229 107 203 236 164  68  63  91 171 165 120 249 208
  18 213 163 155  16 190   5 236 217  69 231 156 170 138  91 161 110 140
  58 218 228 178  59 205  43 177  39  30 237  89 192 164  95  94 154  31
  74
        3  74 195 105 245  70 226 229 107 203 236 164  68  63  91 171 165 120 249
 208  18 213 163 155  16 190   5 236 217  69 231 156 170 138  91 161 110
 140  58 218 228 178  59 205  43 177  39  30 237  89 192 164  95  94 154
  31
        4  31  74 195 105 245  70 226 229 107 203 236 164  68  63  91 171 165 120
 249 208  18 213 163 155  16 190   5 236 217  69 231 156 170 138  91 161
 110 140  58 218 228 178  59 205  43 177  39  30 237  89 192 164  95  94
 154
        5 154  31  74 195 105 245  70 226 229 107 203 236 164  68  63  91 171 165
 120 249 208  18 213 163 155  16 190   5 236 217  69 231 156 170 138  91
 161 110 140  58 218 228 178  59 205  43 177  39  30 237  89 192 164  95
  94
        6  94 154  31  74 195 105 245  70 226 229 107 203 236 164  68  63  91 171
 165 120 249 208  18 213 163 155  16 190   5 236 217  69 231 156 170 138
  91 161 110 140  58 218 228 178  59 205  43 177  39  30 237  89 192 164
  95
        7  95  94 154  31  74 195 105 245  70 226 229 107 203 236 164  68  63  91
 171 165 120 249 208  18 213 163 155  16 190   5 236 217  69 231 156 170
 138  91 161 110 140  58 218 228 178  59 205  43 177  39  30 237  89 192
 164
        8 164  95  94 154  31  74 195 105 245  70 226 229 107 203 236 164  68  63
  91 171 165 120 249 208  18 213 163 155  16 190   5 236 217  69 231 156
 170 138  91 161 110 140  58 218 228 178  59 205  43 177  39  30 237  89
 192
        9 192 164  95  94 154  31  74 195 105 245  70 226 229 107 203 236 164  68
  63  91 171 165 120 249 208  18 213 163 155  16 190   5 236 217  69 231
 156 170 138  91 161 110 140  58 218 228 178  59 205  43 177  39  30 237
  89
        10  89 192 164  95  94 154  31  74 195 105 245  70 226 229 107 203 236 164
  68  63  91 171 165 120 249 208  18 213 163 155  16 190   5 236 217  69
 231 156 170 138  91 161 110 140  58 218 228 178  59 205  43 177  39  30
 237
        11 237  89 192 164  95  94 154  31  74 195 105 245  70 226 229 107 203 236
 164  68  63  91 171 165 120 249 208  18 213 163 155  16 190   5 236 217
  69 231 156 170 138  91 161 110 140  58 218 228 178  59 205  43 177  39
  30
        12  30 237  89 192 164  95  94 154  31  74 195 105 245  70 226 229 107 203
 236 164  68  63  91 171 165 120 249 208  18 213 163 155  16 190   5 236
 217  69 231 156 170 138  91 161 110 140  58 218 228 178  59 205  43 177
  39
        13  39  30 237  89 192 164  95  94 154  31  74 195 105 245  70 226 229 107
 203 236 164  68  63  91 171 165 120 249 208  18 213 163 155  16 190   5
 236 217  69 231 156 170 138  91 161 110 140  58 218 228 178  59 205  43
 177
        14 177  39  30 237  89 192 164  95  94 154  31  74 195 105 245  70 226 229
 107 203 236 164  68  63  91 171 165 120 249 208  18 213 163 155  16 190
   5 236 217  69 231 156 170 138  91 161 110 140  58 218 228 178  59 205
  43
        15  43 177  39  30 237  89 192 164  95  94 154  31  74 195 105 245  70 226
 229 107 203 236 164  68  63  91 171 165 120 249 208  18 213 163 155  16
 190   5 236 217  69 231 156 170 138  91 161 110 140  58 218 228 178  59
 205
        16 205  43 177  39  30 237  89 192 164  95  94 154  31  74 195 105 245  70
 226 229 107 203 236 164  68  63  91 171 165 120 249 208  18 213 163 155
  16 190   5 236 217  69 231 156 170 138  91 161 110 140  58 218 228 178
  59
        17  59 205  43 177  39  30 237  89 192 164  95  94 154  31  74 195 105 245
  70 226 229 107 203 236 164  68  63  91 171 165 120 249 208  18 213 163
 155  16 190   5 236 217  69 231 156 170 138  91 161 110 140  58 218 228
 178
        18 178  59 205  43 177  39  30 237  89 192 164  95  94 154  31  74 195 105
 245  70 226 229 107 203 236 164  68  63  91 171 165 120 249 208  18 213
 163 155  16 190   5 236 217  69 231 156 170 138  91 161 110 140  58 218
 228
        19 228 178  59 205  43 177  39  30 237  89 192 164  95  94 154  31  74 195
 105 245  70 226 229 107 203 236 164  68  63  91 171 165 120 249 208  18
 213 163 155  16 190   5 236 217  69 231 156 170 138  91 161 110 140  58
 218
        20 218 228 178  59 205  43 177  39  30 237  89 192 164  95  94 154  31  74
 195 105 245  70 226 229 107 203 236 164  68  63  91 171 165 120 249 208
  18 213 163 155  16 190   5 236 217  69 231 156 170 138  91 161 110 140
  58
        21  58 218 228 178  59 205  43 177  39  30 237  89 192 164  95  94 154  31
  74 195 105 245  70 226 229 107 203 236 164  68  63  91 171 165 120 249
 208  18 213 163 155  16 190   5 236 217  69 231 156 170 138  91 161 110
 140
        22 140  58 218 228 178  59 205  43 177  39  30 237  89 192 164  95  94 154
  31  74 195 105 245  70 226 229 107 203 236 164  68  63  91 171 165 120
 249 208  18 213 163 155  16 190   5 236 217  69 231 156 170 138  91 161
 110
        23 110 140  58 218 228 178  59 205  43 177  39  30 237  89 192 164  95  94
 154  31  74 195 105 245  70 226 229 107 203 236 164  68  63  91 171 165
 120 249 208  18 213 163 155  16 190   5 236 217  69 231 156 170 138  91
 161
        24 161 110 140  58 218 228 178  59 205  43 177  39  30 237  89 192 164  95
  94 154  31  74 195 105 245  70 226 229 107 203 236 164  68  63  91 171
 165 120 249 208  18 213 163 155  16 190   5 236 217  69 231 156 170 138
  91
        25  91 161 110 140  58 218 228 178  59 205  43 177  39  30 237  89 192 164
  95  94 154  31  74 195 105 245  70 226 229 107 203 236 164  68  63  91
 171 165 120 249 208  18 213 163 155  16 190   5 236 217  69 231 156 170
 138
        26 138  91 161 110 140  58 218 228 178  59 205  43 177  39  30 237  89 192
 164  95  94 154  31  74 195 105 245  70 226 229 107 203 236 164  68  63
  91 171 165 120 249 208  18 213 163 155  16 190   5 236 217  69 231 156
 170
        27 170 138  91 161 110 140  58 218 228 178  59 205  43 177  39  30 237  89
 192 164  95  94 154  31  74 195 105 245  70 226 229 107 203 236 164  68
  63  91 171 165 120 249 208  18 213 163 155  16 190   5 236 217  69 231
 156
        28 156 170 138  91 161 110 140  58 218 228 178  59 205  43 177  39  30 237
  89 192 164  95  94 154  31  74 195 105 245  70 226 229 107 203 236 164
  68  63  91 171 165 120 249 208  18 213 163 155  16 190   5 236 217  69
 231
        29 231 156 170 138  91 161 110 140  58 218 228 178  59 205  43 177  39  30
 237  89 192 164  95  94 154  31  74 195 105 245  70 226 229 107 203 236
 164  68  63  91 171 165 120 249 208  18 213 163 155  16 190   5 236 217
  69
        30  69 231 156 170 138  91 161 110 140  58 218 228 178  59 205  43 177  39
  30 237  89 192 164  95  94 154  31  74 195 105 245  70 226 229 107 203
 236 164  68  63  91 171 165 120 249 208  18 213 163 155  16 190   5 236
 217
        31 217  69 231 156 170 138  91 161 110 140  58 218 228 178  59 205  43 177
  39  30 237  89 192 164  95  94 154  31  74 195 105 245  70 226 229 107
 203 236 164  68  63  91 171 165 120 249 208  18 213 163 155  16 190   5
 236
        32 236 217  69 231 156 170 138  91 161 110 140  58 218 228 178  59 205  43
 177  39  30 237  89 192 164  95  94 154  31  74 195 105 245  70 226 229
 107 203 236 164  68  63  91 171 165 120 249 208  18 213 163 155  16 190
   5
        33   5 236 217  69 231 156 170 138  91 161 110 140  58 218 228 178  59 205
  43 177  39  30 237  89 192 164  95  94 154  31  74 195 105 245  70 226
 229 107 203 236 164  68  63  91 171 165 120 249 208  18 213 163 155  16
 190
        34 190   5 236 217  69 231 156 170 138  91 161 110 140  58 218 228 178  59
 205  43 177  39  30 237  89 192 164  95  94 154  31  74 195 105 245  70
 226 229 107 203 236 164  68  63  91 171 165 120 249 208  18 213 163 155
  16
        35  16 190   5 236 217  69 231 156 170 138  91 161 110 140  58 218 228 178
  59 205  43 177  39  30 237  89 192 164  95  94 154  31  74 195 105 245
  70 226 229 107 203 236 164  68  63  91 171 165 120 249 208  18 213 163
 155
        36 155  16 190   5 236 217  69 231 156 170 138  91 161 110 140  58 218 228
 178  59 205  43 177  39  30 237  89 192 164  95  94 154  31  74 195 105
 245  70 226 229 107 203 236 164  68  63  91 171 165 120 249 208  18 213
 163
        37 163 155  16 190   5 236 217  69 231 156 170 138  91 161 110 140  58 218
 228 178  59 205  43 177  39  30 237  89 192 164  95  94 154  31  74 195
 105 245  70 226 229 107 203 236 164  68  63  91 171 165 120 249 208  18
 213
        38 213 163 155  16 190   5 236 217  69 231 156 170 138  91 161 110 140  58
 218 228 178  59 205  43 177  39  30 237  89 192 164  95  94 154  31  74
 195 105 245  70 226 229 107 203 236 164  68  63  91 171 165 120 249 208
  18
        39  18 213 163 155  16 190   5 236 217  69 231 156 170 138  91 161 110 140
  58 218 228 178  59 205  43 177  39  30 237  89 192 164  95  94 154  31
  74 195 105 245  70 226 229 107 203 236 164  68  63  91 171 165 120 249
 208
        40 208  18 213 163 155  16 190   5 236 217  69 231 156 170 138  91 161 110
 140  58 218 228 178  59 205  43 177  39  30 237  89 192 164  95  94 154
  31  74 195 105 245  70 226 229 107 203 236 164  68  63  91 171 165 120
 249
        41 249 208  18 213 163 155  16 190   5 236 217  69 231 156 170 138  91 161
 110 140  58 218 228 178  59 205  43 177  39  30 237  89 192 164  95  94
 154  31  74 195 105 245  70 226 229 107 203 236 164  68  63  91 171 165
 120
        42 120 249 208  18 213 163 155  16 190   5 236 217  69 231 156 170 138  91
 161 110 140  58 218 228 178  59 205  43 177  39  30 237  89 192 164  95
  94 154  31  74 195 105 245  70 226 229 107 203 236 164  68  63  91 171
 165
        43 165 120 249 208  18 213 163 155  16 190   5 236 217  69 231 156 170 138
  91 161 110 140  58 218 228 178  59 205  43 177  39  30 237  89 192 164
  95  94 154  31  74 195 105 245  70 226 229 107 203 236 164  68  63  91
 171
        44 171 165 120 249 208  18 213 163 155  16 190   5 236 217  69 231 156 170
 138  91 161 110 140  58 218 228 178  59 205  43 177  39  30 237  89 192
 164  95  94 154  31  74 195 105 245  70 226 229 107 203 236 164  68  63
  91
        45  91 171 165 120 249 208  18 213 163 155  16 190   5 236 217  69 231 156
 170 138  91 161 110 140  58 218 228 178  59 205  43 177  39  30 237  89
 192 164  95  94 154  31  74 195 105 245  70 226 229 107 203 236 164  68
  63
        46  63  91 171 165 120 249 208  18 213 163 155  16 190   5 236 217  69 231
 156 170 138  91 161 110 140  58 218 228 178  59 205  43 177  39  30 237
  89 192 164  95  94 154  31  74 195 105 245  70 226 229 107 203 236 164
  68
        47  68  63  91 171 165 120 249 208  18 213 163 155  16 190   5 236 217  69
 231 156 170 138  91 161 110 140  58 218 228 178  59 205  43 177  39  30
 237  89 192 164  95  94 154  31  74 195 105 245  70 226 229 107 203 236
 164
        48 164  68  63  91 171 165 120 249 208  18 213 163 155  16 190   5 236 217
  69 231 156 170 138  91 161 110 140  58 218 228 178  59 205  43 177  39
  30 237  89 192 164  95  94 154  31  74 195 105 245  70 226 229 107 203
 236
        49 236 164  68  63  91 171 165 120 249 208  18 213 163 155  16 190   5 236
 217  69 231 156 170 138  91 161 110 140  58 218 228 178  59 205  43 177
  39  30 237  89 192 164  95  94 154  31  74 195 105 245  70 226 229 107
 203
        50 203 236 164  68  63  91 171 165 120 249 208  18 213 163 155  16 190   5
 236 217  69 231 156 170 138  91 161 110 140  58 218 228 178  59 205  43
 177  39  30 237  89 192 164  95  94 154  31  74 195 105 245  70 226 229
 107
        51 107 203 236 164  68  63  91 171 165 120 249 208  18 213 163 155  16 190
   5 236 217  69 231 156 170 138  91 161 110 140  58 218 228 178  59 205
  43 177  39  30 237  89 192 164  95  94 154  31  74 195 105 245  70 226
 229
        52 229 107 203 236 164  68  63  91 171 165 120 249 208  18 213 163 155  16
 190   5 236 217  69 231 156 170 138  91 161 110 140  58 218 228 178  59
 205  43 177  39  30 237  89 192 164  95  94 154  31  74 195 105 245  70
 226
        53 226 229 107 203 236 164  68  63  91 171 165 120 249 208  18 213 163 155
  16 190   5 236 217  69 231 156 170 138  91 161 110 140  58 218 228 178
  59 205  43 177  39  30 237  89 192 164  95  94 154  31  74 195 105 245
  70
        54  70 226 229 107 203 236 164  68  63  91 171 165 120 249 208  18 213 163
 155  16 190   5 236 217  69 231 156 170 138  91 161 110 140  58 218 228
 178  59 205  43 177  39  30 237  89 192 164  95  94 154  31  74 195 105
 245
        55 245  70 226 229 107 203 236 164  68  63  91 171 165 120 249 208  18 213
 163 155  16 190   5 236 217  69 231 156 170 138  91 161 110 140  58 218
 228 178  59 205  43 177  39  30 237  89 192 164  95  94 154  31  74 195
 105;